Gll^Fdw, Gll^Fdw, Gll^Fdw, Ww, Wo, Wo, Wo, Md, Mm^Xm, Mm^Xm, Mm^Xm, Mm^Xm, Md, Md, Md, Md, Md, Md, Ww, Md, Mm^Xm, Md, Md, Md, Md, Md, Md, Md, Md, Md, Md, Mm^Xm, Mm^Xm, Mm^Xm
Gll^Fdw, Gll^Fdw, Gll^Fdw, Ww, Ww, Wo, Mm^Xm, Mm^Xm, Mm^Xm, Mm^Xm, Mm^Xm, Mm^Xm, Md, Md, Md, Md, Md, Ww, Ww^Vm, Md, Mm^Xm, Mm^Xm, Mm^Xm, Md, Md, Md, Wo, Wo, Wo, Wo, Wo, Mm^Xm, Mm^Xm, Mm^Xm
Mm^Xm, Hhd^Fdw, Gd^Vhcr, Gll^Fdw, Chr, Chr, Chr, Mm^Xm, Mm^Xm, Mm^Xm, Mm^Xm, Md, Md, Md, Hh^Fp, Md, Ww, Ww, Md, Md, Md, Mm^Xm, Mm^Xm, Md, Md, Md, Md, Wo, Wo, Wo, Mm^Xm, Mm^Xm, Mm^Xm, Mm^Xm
Mm^Xm, Mm^Xm, Md, Gd^Fdw, Chr, 3 Khr, Chr, Mm^Xm, Qxu, Mm, Mm, Md^Vhhr, Ce, Ce, Ce, Hh^Fp, Ww, Hh, Hh, Md, Md, Md, Md, Md, Hh, Md, Ww, Wo, Wo, Wo, Md, Mm^Xm, Md, Md
Mm^Xm, Mm^Xm, Mm^Xm, Mm^Xm, Qxu, Chr, Qxu^Bp\, Qxu^Bp\, Qxu, Mm, Hh^Fp, Hh^Fp, Ce, Hh^Ecf, 2 Ke, Gg^Fp, Wwf, Hh, Hh, Hh, Ss, Md, Hh, Hh, Hh, Hh, Ww, Wo, Wo, Wo, Hh, Hh, Hh, Gg
Mm^Xm, Mm^Xm, Mm^Xm, Mm^Xm, Mm, Qxu, Qxu, Qxu, Rp, Rp^Fdw, Hh^Fp, Hh^Fp, Hh^Fp, Ce, Gg^Fp, Gg, Gg, Wwf, Hh, Hh, Ss, Ss, Ss, Hh, Hh, Hh, Ww, Ww, Wo^Vm, Ww, Hh, Hh, Hh, Hh
Mm, Mm, Gg, Mm, Gg, Gg^Fp, Hh^Fp, Gg^Fp, Rp, Hh^Fp, Hh^Fp, Gg^Fp, Gg^Fp, Gg^Fp, Gg^Fp, Gg, Gg, Ww, Wwf, Ss, Ss, Ss, Hh, Hh, Gg^Fp, Gg^Fp, Hh^Fp, Ww, Ww, Ww, Hh^Fp, Hh, Hh, Hh
Hh, Hh, Hh, Gg, Hh, Gg, Hh^Fp, Hh^Fp, Gg^Fp, Rp^Fdw, Hh^Fp, Hh^Fp, Gg^Fp, Gg^Fp, Gg^Fp, Gg, Gg, Ww, Wwf, Gg, Gg, Gg, Gg^Fp, Gg^Fp, Hh^Fp, Gg^Fp, Hh^Fp, Ww, Ww, Hh^Fp, Hh^Fp, Gg, Gg, Gg
Hh, Hh, Gg^Gvs, Hh, Gg, Gg, Gg, Hh^Fp, Rb, Rp, Gg^Fp, Gg^Fp, Gg^Fp, Gg^Fp, Gg^Fp, Gg, Rb, Gg^Vhr, Ww, Wwf, Gg, Hh^Vhhr, Hh^Fp, Hh^Fp, Hh^Fp, Hh, Hh^Fp, Ww, Ww, Hh^Fp, Gg^Fp, Gg^Fp, Gg^Fp, Gg
Gg^Gvs, Gs^Vl, Rb, Gg^Gvs, Ch, Gg, Rb, Rb, Gg, Rb, Rb, Rb, Rb, Rb, Rb, Rb, Gg, Rb, Ww^Bsb\, Wwf, Gg, Gg^Fp, Gg^Fp, Hh^Fp, Gg^Fp, Gg^Fp, Ww, Ww, Ww, Gg^Fp, Gg^Fp, Gg^Fp, Gg, Gg
Rb, Rb, Gg^Fp, Rb, Rb, Rb, Gg, Gg, Gg, Gg^Fp, Gg^Fp, Gg^Fp, Gg^Fp, Gg^Fp, Gg^Fp, Gg^Fp, Gg, Ww, Gg^Efm, Rb, Rb, Gg, Gg^Fp, Gg^Fp, Gg^Fp, Ss, Ww^Ewf, Ww, Ww, Ss, Gg^Fp, Gg^Fp, Gg, Gg
Gg, Gg^Fp, Ss, Ss, Rb, Gg, Gg, Gg, Hh^Fp, Hh, Hh, Hh, Gg^Fp, Gg^Fp, Gg^Fp, Gg^Fp, Gg, Wwf, Gg^Efm, Gg^Efm, Gg^Efm, Rb, Rb, Gg^Fp, Gg^Fp, Ss, Ss, Ww, Ss, Ss, Gg^Fp, Gg^Fp, Gg, Gg
Gg, Gg^Fp, Ss, Ww, Rb, Hh^Fp, Hh^Fp, Hh^Fp, Mm, Hh^Fp, Hh^Fp, Hh, Gg^Fp, Gg^Fp, Gg, Gg^Fp, Ww, Ww, Gg^Efm, Gg^Efm, Gg^Efm, Gg, Gg, Rb, Rb, Rb, Rb, Ss, Gg^Fp, Gg^Fp, Gg^Fp, Gg^Fp, Gg, Gg
Gg^Gvs, Gg^Fp, Rb, Rb, Ww^Ewf, Gg^Fp, Hh^Fp, Mm, Mm, Mm, Hh^Fp, Hh^Fp, Hh^Fp, Gg^Fp, Gg^Fp, Gg, Ww, Hh, Hh, Hh, Hh, Gg^Efm, Gg, Gg, Gg, Gg, Gg, Rb, Rb, Rb, Rb, Rb, Rb, Gg
Rb, Rb, Ss, Ww, Ss, Hh^Fp, Ss, Hh, Ss, Hh, Gg^Fp, Gg^Fp, Hh^Fp, Hh, Ss, Ww^Vm, Ss, Hh^Fp, Hh^Fp, Hh^Fp, Gg^Efm, Gg^Efm, Gg^Efm, Gg, Gg, Gg, Ss, Gg, Gg, Gg, Cte, Gg, Ss, Gg
Gg, Ss, Ss, Ss, Ss, Ss, Gg, Gg, Ss, Gg^Fp, Gg^Fp, Gg^Fp, Gg^Fp, Hh^Fp, Gg^Fp, Ss, Hh^Fp, Hh^Fp, Hh^Fp, Hh, Gg^Efm, Gg^Efm, Gg^Efm, Ss, Gg^Efm, Ss, Gg, Ss^Vhs, Gg, Gg, Cte, Chs, Ss, Ss
Gg, Ss, Ss, Ss, Ss, Ss, Ss, Ss, Ss, Ss, Ss, Ss, Ss, Gg^Fp, Ss, Gg^Fp, Gg^Fp, Hh^Fp, Hh, Ss, Ss, Gg^Efm, Ss, Gg^Efm, Ss, Ss, Gg, Gg, Ss, Cte, Chs, 1 Khs, Ss, Ss
Gg, Ss, Ss, Ss, Ss, Ss, Ss, Ss, Ss, Ss, Ss, Ss, Ss, Ss, Ss, Ss, Ss, Ss, Ss, Ss, Ss, Ss, Ss, Ss, Ss, Ss, Ss, Ss, Ss, Ss, Ss, Ss, Ss, Ss
