Xoc, Xoc, Xoc, Xoc, Xoc, Xoc, Xoc, Xoc, Xoc, Xoc, Xoc
Xoc, Xoc, Xoc, Xoc, Ql, 1 Kud, Ql, Xoc, Xoc, Xoc, Xoc
Xoc, Xoc, Mv, Ql, Ql, Irs, Ql, Ql, Mv, Xoc, Xoc
Xoc, Xoc, Xoc^Efs, Ql, Irs, Irs, Irs, Ql, Xoc^Efs, Xoc, Xoc
Ql, Irs^Vhc, Irs, Irs, Irs, Irs, Irs, Irs, Irs, Irs^Vhc, Ql
Ql, Ql, Gg^Fet, Irs, Irs, Irs, Irs, Irs, Gg^Fet, Ql, Ql
Ql, Ql, Gg^Ii, Gg^Ii, Irs, Irs, Irs, Gg^Ii, Gg^Ii, Ql, Ql
Xoc, Irs^Vhc, Irs^Ftp, Irs, Irs, Irs, Irs, Irs, Irs^Ftp, Irs^Vhc, Xoc
Xoc, Xoc, Irs^Ftp, Irs, Irs, Irs, Irs, Irs, Irs^Ftp, Xoc, Xoc
Xoc, Irs^Ftp, Irs, Irs, Irs, Irs, Irs, Irs, Irs, Irs^Ftp, Xoc
Xoc, Irs^Ftp, Irs^Vhc, Irs, Irs, Irs, Irs, Irs, Irs^Vhc, Irs^Ftp, Xoc
Xoc, Xoc, Xoc, Xoc, Irs, Irs, Irs, Xoc, Xoc, Xoc, Xoc
