Gll^Efm, Gll^Efm, Hh, Hh, Hh^Fp, Hh^Fp, Hh^Fp, Hh^Fp, Hh^Fp, Hh, Ss, Ss, Ss, Ss, Ss, Ss, Mm, Mm, Mm, Mm
Gll^Efm, Gll^Efm, Hh, Hh^Fp, Ww, Hh, Hh, Hh^Fp, Hh, Hh, Gll^Fp, Gll^Fmw, Gll^Fmw, Ss, Gll^Fmw, Ss, Mm, Mm, Mm, Mm
Gll^Efm, Gll^Efm, Ss, Ww, Hh, Hh, Ww, Ss, Ss^Vhs, Gll^Fp, Gll^Fmw, Gll^Fp, Gll^Fp, Gll^Fp, Gll^Fp, Gll^Fp, Mm, Mm, Mm, Hh^Fp
Gll^Efm, Gll^Fp, Gll^Fp, Ww, Hh, Hh, Ww, Ss, Gll, Gll^Fmw, Gll^Fp, Ww, Ce, Ce, Gll, Gll^Fp, Mm^Vhhr, Mm, Hh, Hh^Fp
Gll, Gll^Fp, Ww, Ww, Ww, Ww, Gll, Gll, Gll^Fp, Gll, Ww, Ww, 2 Ke, Gll^Ecf, Ce, Gll, Ww, Gll, Gll, Hh^Fp
Gll, Ww, Gll, Gll, Gll, Gll, Ss, Gll, Ss^Bw\r, Ss, Ww, Ww, Ww, Ce, Ww, Ww, Ss, Ss, Ss, Gll
Ss, Gll, Gll, Gll, Ss, Ss, Gll^Fp, Ss, Gll^Fp, Gll, Gll^Fp, Ww, Gll^Fp, Ww^Bw|r, Gll^Fp, Ww^Vm, Gll^Fp, Ss, Gll, Ss
Ss, Ss, Ss, Ss, Gll^Fp, Gll^Fp, Gll^Fp, Gll^Fp, Gll^Fp, Gll, Gll, Gll^Fp, Gll, Gll, Gll, Gll, Gll, Gll, Gll, Gll
Ss, Ss, Gll^Fp, Gll^Fp, Gll^Fp, Gll^Fp, Gll^Fp, Gll^Fp, Ss^Bw/r, Gll, Ss, Gll, Ss^Vhs, Gll^Fp, Gll^Fp, Gll^Fp, Gll^Fp, Gll^Fp, Gll^Fp, Gll
Gll^Fp, Gll^Fp, Hh^Uf, Hh^Fp, Hh^Uf, Gll^Fp, Gll^Em, Gll^Em, Gll^Em, Ss, Ss, Ss, Ss, Gll^Fp, Gll^Fp, Gll^Fp, Gll^Fp, Gll^Fp, Gll^Fp, Gll^Fp
Gll^Fp, Gll^Fp, Gll^Fp, Gll^Fp, Gll^Fp, Gll^Fp, Gll^Em, Gd^Fetd, Gll^Em, Gll^Em, Gll^Em, Ss, Ss, Gll^Fp, Hh, Gll^Fmw, Gll^Fp, Gll^Fp, Gll^Fp, Gll^Fp
Gll^Fp, Gll^Fp, Gll^Fp, Ss, Ss, Ss, Ss, Gll^Em, Gll^Em, Gll^Em, Gll^Fp, Gll^Fp, Ss, Ss, Hh, Hh^Fp, Hh^Fp, Gll^Fp, Gll, Gll
Gll^Fp, Gll^Fp, Ww^Vm, Ss, Ss, Ss, Ss, Ss, Ss, Gll^Fp, Hh^Fp, Gll^Fp, Ss, Ss, Ss, Hh, Hh, Gll^Fp, Gll^Fp, Gll
Ww, Ww, Ww, Ss, Ww, Ss, Ss, Ss, Hh, Gll^Fp, Gll^Fp, Ss, Ss, Ss, Gll^Fmw, Gll^Fmw, Gll^Fmw, Gll^Fp, Gll^Fp, Gll^Fp
Ww, Ww, Ww, Ww, Ss, Ss, Ww, Ww, Ww, Hh, Ss, Ss, Ss, Ss^Vhs, Gll^Fmw, Gll^Fmw, Gll^Fmw, Gll^Fmw, Gll^Fp, Gll^Fp
Ww, Ww, Ww, Gll^Fp, Gll^Fp, Ww, Ww, Ww, Hh^Fp, Hh^Fp, Sm, Sm, Sm, Sm, Gll^Fp, Gll^Fmw, Gll^Fmw, Gll^Fmw, Ss, Ss
Gll^Fp, Gll^Fp, Gll^Fp, Gll^Fp, Ww, Ss, Ss^Vhs, Sm, Sm, Hh^Fp, Co, Sm, Sm, Gll^Fp, Gll^Fp, Gll^Fp, Gll^Fp, Gll^Fp, Gll^Fp, Gll^Fp
Gll^Fp, Gll^Fp, Gll^Fp, Ww, Ss, Ww, Sm, Sm, Co, Co, 1 Ko, Hh^Fp, Sm, Gll^Fp, Gll^Fp, Gll^Fp, Gll^Fp, Gll^Fp, Gll^Fp, Gll^Fp
Gll^Fp, Gll^Fp, Ss, Ss, Ss, Ww, Sm, Sm, Co, Hh^Fp, Hh^Fp, Hh^Fp, Sm, Sm, Ss, Gll^Fp, Ss, Gll^Fp, Gll^Fp, Gll^Fp
Gll^Fp, Ss, Ss, Ss, Ss, Ss, Ss, Sm, Ss, Hh^Fp, Sm, Sm, Sm, Sm, Ss, Ss, Ss, Ss, Ss, Gll^Fp
