Mm, Mm, Mm, Mm, Mm, Mm, Mm, Mm, Mm, Hh, Hh, Hh, Hh, Gg, Gg^Fms, Gg^Fms, Gg^Fms, Gg^Fms, Gg^Fms, Gg^Fms, Ww, Ww, Wo, Ww, Wo, Wo, Ww, Ww, Ww, Gg, Mm, Mm, Mm, Gg, Mm, Hh, Hh^Fms, Gg^Fms
Mm, Mm, Mm, Mm, Hh, Hh, Hh, Mm, Hh, Hh, Mm, Hh, Mm, Hh, Hh, Hh^Fms, Hh, Gg^Fms, Gg^Fms, Gg^Fms, Ww, Wo, Wo, Wo, Ww, Ww, Hh, Ww, Mm, Mm, Mm, Mm, Hh^Fms, Mm, Hh^Fms, Hh^Fms, Gg^Fms, Gg^Fms
Mm, Mm, Mm, Mm, Hh, Hh, Mm, Hh, Mm, Mm, Mm, Mm, Mm, Mm, Hh^Fms, Mm, Hh^Fms, Gg^Fms, Gg^Fms, Ww, Ww, Wo, Wo, Ww^Vm, Hh, Hh, Mm, Mm, Mm, Mm, Mm, Mm, Hh^Fms, Hh^Vl, Gg^Fms, Gg^Fms, Rb, Rb
Mm, Mm, Mm, Mm, Hh, Mm, Mm, Hh, Mm, Mm, Hh^Fms, Hh^Fms, Hh^Fms, Hh^Fms, Hh^Fms, Hh^Fms, Gg^Fms, Gg^Fms, Gg^Fms, Gg^Fms, Ww, Ww, Ww, Gg^Fms, Hh^Fms, Mm, Mm, Mm, Mm, Mm, Mm, Mm, Hh^Fms, Gg^Fms, Ce, Rb, Rb, Rb
Mm, Mm, Gs^Fms, Gs^Fms, Gs^Fms, Hh, Gs^Fms, Mm, Hh^Fms, Hh^Fms, Gg^Fms, Gg^Fms, Gg^Fms, Gg^Fms, Gg^Fms, Gg^Fms, Gg^Fms, Gg^Fms, Ww, Ww, Ww, Ww, Gg^Fms, Gg^Fms, Hh^Fms, Hh^Fms, Mm, Mm, Hh^Fms, Hh^Fms, Hh^Fms, Hh^Fms, Rb, Ce, 1 Ke, Ce, Rb, Rb
Mm, Gs^Fms, Gs^Fms, Gs^Fms, Gs^Fms, Gs^Fms, Gs^Fms, Gs^Fms, Gg^Fms, Gg^Fms, Gg^Fms, Gg^Fms, Gg^Fms, Gg^Fms, Gg^Fms, Gg^Fms, Gg^Fms, Gg^Fms, Ww, Ww, Ww, Ww, Gg^Fms, Gg^Fms, Mm, Mm, Hh^Fms, Hh^Fms, Gg^Fms, Gg^Fms, Gg^Fms, Gg^Fms, Rb, Ce, Ce, Ce, Gg^Fms, Gg^Fms
Gs^Fms, Gs^Fms, Gs^Fms, Gs^Fms, Gs^Fms, Gs^Fms, Gs^Fms, Gs^Fms, Hh^Fms, Gg^Fms, Mm, Gg^Fms, Mm, Gg^Fms, Gg^Fms, Gg^Fms, Gg^Fms, Gg^Fms, Ww, Ww, Gg^Fms, Gg^Fms, Gg^Fms, Gg^Fms, Mm, Mm, Hh^Fms, Gg^Fms, Gs^Vc, Gg^Fms, Rb, Rb, Gg, Gg, Gg, Gs^Vc, Gg^Fms, Gg^Fms
Gs^Fms, Gs^Fms, Gs^Fms, Gs^Fms, Gg^Fms, Gg^Fms, Hh^Fms, Hh^Fms, Mm, Mm, Mm, Mm, Hh^Fms, Mm, Gg^Fms, Gg^Fms, Gg^Fms, Gg^Fms, Ww, Gg^Fms, Gg^Fms, Gg^Fms, Gg^Fms, Gg^Fms, Gg^Fms, Mm, Gg^Fms, Gg^Fms, Rb, Rb, Gg, Gg, Gg, Gg, Gg, Gg, Gg^Fms, Gg^Fms
Gg^Fms, Gs^Fms, Gs^Fms, Gs^Fms, Gg^Fms, Hh^Fms, Hh^Fms, Mm, Ww^Vm, Mm, Mm, Mm, Hh^Fms, Hh^Fms, Hh^Fms, Gg^Fms, Gg, Ww, Gg^Fms, Gg^Fms, Gg^Fms, Gg^Fms, Gg^Fms, Gg^Fms, Gg^Fms, Gg^Fms, Gg^Fms, Gg^Fms, Rb, Gg, Gg, Gg, Gg, Gg, Hh^Fms, Hh^Fms, Hh^Fms, Hh^Fms
Gg^Fms, Gg^Fms, Gg^Fms, Gg^Fms, Hh^Fms, Hh^Fms, Mm, Mm, Ww, Ww, Hh^Fms, Hh^Fms, Ww, Gg^Fms, Gg^Fms, Gg^Fms, Ww, Ww, Gg^Fms, Gg^Fms, Gg^Fms, Gg^Fms, Gg^Fms, Gg^Fms, Rb, Rb, Rb, Rb, Gg, Gg, Gg, Gg, Hh^Fms, Hh^Fms, Mm, Mm, Mm, Mm
Gg^Fms, Gg^Fms, Gg^Fms, Gg^Fms, Hh^Fms, Mm, Hh, Mm, Ww, Ww, Ww, Ww, Ww, Gg^Fms, Gg^Fms, Gg^Fms, Ww, Ww, Gg^Fms, Gg^Fms, Gg^Fms, Gg^Fms, Rb, Rb, Gg, Gg, Gg, Gg, Gg, Gg, Hh, Hh^Fms, Hh^Fms, Mm, Mm, Mm, Mm, Gg
Gg^Fms, Gg^Fms, Gg^Fms, Gg^Fms, Hh^Fms, Mm, Mm, Mm, Mm, Mm, Mm, Hh, Ww, Gg^Fms, Gg^Fms, Gg^Fms, Ww, Gg^Fms, Gg^Fms, Gg^Fms, Gg, Rb, Gg, Gg, Gg, Gg, Gg, Gg, Gg, Hh, Hh, Hh, Mm, Mm, Hh^Fms, Mm, Hh^Fms, Hh
Gg^Fms, Gg^Fms, Gg^Fms, Gg^Fms, Gg^Fms, Hh^Fms, Mm, Mm, Mm, Hh, Hh, Ww, Ww, Gg^Fms, Ww, Gg^Fms, Ww, Ww, Gg^Fms, Gg, Gg, Rb, Gg, Gg, Gg, Gg, Gg, Gg, Gg, Hh, Hh, Hh, Hh, Hh, Hh^Fms, Hh^Fms, Gg^Fms, Gg^Fms
Gg^Fms, Gg^Fms, Gg^Fms, Gg^Fms, Gg^Fms, Hh^Fms, Hh^Fms, Mm, Hh^Fms, Hh, Gll^Gvs, Ww, Ww, Ww, Ww, Ww, Ww, Wo, Ww, Gg, Gg, Rb, Gg, Gg, Gg, Gg, Gg, Gg, Gg, Gg, Gg, Gg, Gg, Gg, Gg, Hh^Fms, Gg^Fms, Gg^Fms
Gg^Fms, Gg^Fms, Gg^Fms, Gg^Fms, Gg^Fms, Gg^Fms, Gg^Fms, Hh^Fms, Gg^Fms, Gg^Fms, Gll^Gvs, Gll^Gvs, Rb, Rb, Rb, Rb, Rb, Ww, Gg, Ww, Ww, Rb, Gs^Vh, Gg, Gg, Gg, Hh, Gg^Fms, Gg^Fms, Gg, Gg, Gg, Gg, Gg, Gg, Gg, Gg^Fms, Gg^Fms
Hh^Fms, Hh^Fms, Hh, Hh^Fms, Hh^Fms, Gg^Fms, Gg^Fms, Gg^Fms, Gg^Fms, Gg^Fms, Gll^Gvs, Rb, Hh, Rb, Hh, Hh, Hh, Rb, Rb, Gg, Ch, Ww^Bsb|, Ww, Gg, Gg, Gg, Gg^Fms, Hh^Fms, Gg^Fms, Gg^Fms, Gg, Gg, Gg, Gg, Gg^Fms, Gg^Fms, Gg^Fms, Gg^Fms
Hh^Fms, Hh^Fms, Mm, Mm, Hh^Fms, Gg^Fms, Gg^Fms, Gll^Gvs, Gll^Gvs, Gll^Gvs, Gll^Gvs, Rb, Hh, Hh, Mm, Mm, Hh, Hh, Rb, Ch, Ch, Rb, Ww, Gg, Gg, Gg, Gg, Hh^Fms, Gg^Fms, Gg^Fms, Gg, Gg, Gg^Fms, Gg^Fms, Gg^Fms, Gg^Fms, Gg^Fms, Gg^Fms
Hh^Fms, Hh^Fms, Mm, Mm, Hh^Fms, Gg^Fms, Gg^Fms, Gll^Gvs, Gll^Gvs, Gll^Gvs, Gll^Vwm, Rb, Hh, Hh, Mm, Mm, Mm, Hh, Gg, Rb, Rb, Rb, Ww, Ww, Gg, Gg, Gg, Gg, Gg, Gg, Gg^Fms, Gg^Fms, Gg^Fms, Gg^Fms, Gg^Fms, Gg^Fms, Ss, Gg^Fms
Gg^Fms, Hh^Fms, Hh^Fms, Hh^Fms, Gg^Fms, Gg^Fms, Gg^Fms, Gll^Gvs, Gll^Gvs, Gll^Gvs, Gll^Gvs, Hh, Hh, Mm, Mm, Mm, Hh, Hh, Gg, Gs^Vh, Rb, Ww, Gg, Gg, Gg, Gg, Gg, Gg, Gg, Gg, Gg^Fms, Gg^Fms, Gg^Fms, Gg^Fms, Ss, Ss, Ss, Ss
Gg^Fms, Gg^Fms, Gg^Fms, Gg^Fms, Gg^Fms, Gg^Fms, Gll^Gvs, Gll^Gvs, Gll^Gvs, Gll^Gvs, Gll^Gvs, Hh, Hh, Mm, Mm, Mm, Hh, Hh, Ww, Ww, Ww^Bsb|, Ww, Gg, Gg, Gg, Gg, Gg, Gg, Gg, Gg, Gs^Vl, Gg^Fms, Gg^Fms, Gg^Fms, Ss, Ss, Ss, Ss
Gg^Fms, Gg^Fms, Gg^Fms, Gg^Fms, Gg^Fms, Gg^Fms, Gll^Gvs, Gll^Gvs, Gll^Gvs, Gll^Gvs, Gll^Gvs, Gll^Gvs, Hh, Mm, Mm, Mm, Hh, Ww, Wo, Wo, Rb, Gg^Efm, Hh^Fms, Gg, Gg, Gg, Gg, Gg, Gg^Fms, Gg^Fms, Gg^Fms, Gg^Fms, Gg^Fms, Gg^Fms, Gg^Fms, Ss, Gg^Fms, Gg^Fms
Gg^Fms, Gg^Fms, Gg^Fms, Gg^Fms, Gll^Vwm, Gll^Gvs, Gll^Gvs, Gll^Gvs, Gll^Gvs, Gll^Gvs, Gll^Gvs, Gll^Gvs, Gll^Gvs, Hh, Hh, Hh, Ww, Ww, Rb, Rb, Gg^Efm, Gg^Efm, Hh^Fms, Hh^Fms, Hh^Fms, Hh^Fms, Hh^Fms, Hh^Fms, Gg^Fms, Gg^Fms, Gg^Fms, Gg^Fms, Gg^Fms, Gg^Fms, Gs^Fms, Ss, Ss, Ss
Gg^Fms, Gg^Fms, Gg^Fms, Gg^Fms, Gll^Gvs, Gll^Gvs, Ww, Gll^Gvs, Ww, Gll^Gvs, Ww, Ww, Gll^Gvs, Gll^Gvs, Ww, Ww, Rb, Rb, Gg^Efm, Gg^Efm, Gg^Efm, Gg^Efm, Hh^Fms, Mm^Fms, Mm, Mm^Fms, Mm, Hh^Fms, Gg^Fms, Gg^Fms, Ss, Gg^Fms, Gs^Fms, Gs^Fms, Gs^Fms, Gs^Fms, Gs^Fms, Gs^Fms
Gg^Fms, Gg^Fms, Gg^Fms, Gll^Gvs, Gll^Gvs, Ww, Wo, Ww, Rr, Ww, Rr, Ww, Ww, Ww, Wo, Wo, Rb, Gg^Efm, Gg^Efm, Gg^Efm, Gg^Efm, Hh^Fms, Hh^Fms, Mm^Fms, Mm, Mm, Hh^Fms, Hh^Fms, Ss, Gg^Fms, Ss, Ss, Hh^Fms, Hh^Fms, Hh^Fms, Hh^Fms, Gs^Fms, Gs^Fms
Gg^Fms, Gg^Fms, Wo, Ww, Ww, Ww, Rr^Vhc, Chw, Rr, Rr, Rr^Vhc, Rr, Rr, Chw, Rr, Rr, Ch, Ww, Gg^Efm, Gg^Efm, Ds, Hh^Fms, Hh, Mm^Fms, Mm, Hh, Hh^Fms, Hh^Fms, Ss, Ss, Ss, Hh^Fms, Hh^Fms, Gs^Fms, Hh^Fms, Hh^Fms, Hh^Fms, Gs^Fms
Ww, Ww, Wo, Wo, Hh^Fms, Hh^Fms, Hh^Fms, Hh^Fms, Rr, Rr, Rr, Rr, Rr, Rr, Rr, Rr, Ww, Ww, Gg^Efm, Ds, Wwf, Wwf, Wwf, Mm, Ww, Mm, Mm, Hh^Fms, Hh^Fms, Ss, Hh^Fms, Ss, Ss, Hh^Fms, Hh^Fms, Hh^Fms, Gs^Fms, Gs^Fms
Ww, Wo, Hh^Fms, Hh^Fms, Hh^Fms, Hh^Fms, Mm, Hh^Fms, Hh^Fms, Rr, Rr, Rr, Rr, Rr, Rr, Rr, Rr, Ww, Gg^Efm, Ds, Wwf, Wwf, Ww, Ww, Ww, Hh^Fms, Hh^Fms, Hh^Fms, Hh^Fms, Gg^Fms, Hh^Fms, Hh^Fms, Ss, Chs, Hh^Fms, Hh^Fms, Gs^Fms, Gs^Fms
Ww, Hh^Fms, Mm, Hh^Fms, Mm, Mm, Mm, Hh^Fms, Rr^Vhc, Rr, Rr, Rr, Rr, Rr, Rr, Rr^Vhc, Ch, Ww, Ds, Ds, Wwf, Ww, Wo, Ww, Gg^Fms, Gg^Fms, Gg^Fms, Gg^Fms, Gg^Fms, Gg^Fms, Hh^Fms, Hh^Fms, Ss, Chs, Hh^Fms, Hh^Fms, Gs^Fms, Gs^Fms
Gg^Fms, Hh^Fms, Mm, Mm, Mm, Mm, Mm^Fms, Hh^Fms, Hh^Fms, Rr, Ch, Rr, Rr, Rr, Rr, Ch, Ch, Ww, Wwf, Wwf, Wwf, Ww, Ww, Ww, Gg^Fms, Gg^Fms, Gg^Fms, Gg^Fms, Hh^Fms, Hh^Fms, Hh^Fms, Ss, Ss, Hh^Fms, Hh^Fms, Hh^Fms, Hh^Fms, Gs^Fms
Hh^Fms, Hh^Fms, Mm^Fms, Mm, Mm^Fms, Mm^Fms, Hh^Fms, Hh^Fms, Rr^Vhc, Ch, 2 Kh, Ch, Rr^Vhc, Rr, Rb, Rr^Vhc, Ch, Wwf, Wwf, Wwf, Wwf, Ww, Gs^Fms, Gg^Fms, Gs^Fms, Gg^Fms, Hh^Fms, Hh^Fms, Gs^Fms, Hh^Fms, Ss^Vhs, Ss, Ss, Ss, Hh^Fms, Hh^Fms, Hh^Fms, Hh^Fms
Hh^Fms, Hh^Fms, Hh^Fms, Hh^Fms, Hh^Fms, Hh^Fms, Gs^Fms, Ch, Ch, Ch, Gs^Fms, Ch, Ch, Ch, Rb, Ch, Gs^Fms, Gs^Fms, Gs^Fms, Gs^Fms, Gs^Fms, Wwf, Gs^Fms, Gs^Fms, Gs^Fms, Hh^Fms, Hh^Fms, Gs^Fms, Hh^Fms, Hh^Fms, Ss, Ss, Hh^Fms, Gs^Fms, Hh^Fms, Hh^Fms, Hh^Fms, Hh^Fms
Gg^Fms, Hh^Fms, Hh^Fms, Hh^Fms, Hh^Fms, Gs^Fms, Gs^Fms, Gs^Fms, Gs^Fms, Gs^Fms, Gs^Fms, Gs^Fms, Gs^Fms, Rb, Rb, Rb, Gs^Fms, Gs^Fms, Gs^Fms, Gs^Fms, Gs^Fms, Gs^Fms, Gs^Fms, Gs^Fms, Gs^Fms, Gs^Fms, Gs^Fms, Hh^Fms, Hh^Fms, Hh^Fms, Hh^Fms, Ss, Ss, Hh^Fms, Hh^Fms, Hh^Fms, Hh^Fms, Hh^Fms
