Hh, Hh, Hh, Mm, Mm, Mm, Mm, Mm, Mm, Ww, Wo, Ww, Mm, Mm, Mm, Mm, Mm, Mm, Hh, Hh, Hh, Gg, Ss, Chs, Chs, Chs, Ss, Ss, Ss, Ss, Ss, Ss, Mm, Mm, Mm, Mm, Mm, Mm, Mm, Mm, Mm, Gg
Gg, Hh, Hh, Hh, Hh, Mm, Hh, Hh, Mm, Ww, Wo, Ww, Mm, Mm, Hh, Mm, Hh^Fms, Mm, Hh^Fms, Hh, Ss, Ss, Ss, Ss, Chs, Ss, Ss, Ss, Hh^Fms, Ss, Ss, Ss, Mm, Mm, Ww, Ww, Ww, Ww^Vm, Mm, Mm, Mm, Gg
Gg, Gg, Gg, Hh, Ss^Fms, Hh^Fms, Gg, Gg, Hh^Fms, Ww, Ww, Ww, Hh^Fms, Hh^Fms, Gg, Gg, Gg, Gg, Gg, Gs^Fms, Gs^Fms, Ss, Ss, Ss, Gs^Fms, Gs^Fms, Gg, Gg, Gg, Hh^Fms, Hh^Fms, Ss, Mm, Ww, Ww, Ww, Ww, Ww, Mm, Mm, Mm, Mm
Gg, Gg, Gg, Gg^Fms, Gg, Gg, Gg, Gg^Fms, Gg^Fms, Hh^Fms, Ww, Ww, Gg, Hh, Ss^Vhs, Ss, Ss, Gs^Fms, Gs^Fms, Gs^Fms, Gs^Fms, Ss, Gs^Fms, Gs^Fms, Gs^Fms, Gs^Vl, Gs^Fms, Gg, Gg, Gg, Hh^Fms, Hh^Fms, Ww, Ww, Ww, Hh, Hh^Fms, Mm, Mm, Mm, Hh^Fms, Hh^Fms
Gs^Fms, Gs^Fms, Gs^Fms, Gg, Gg^Fms, Gg^Fms, Gg, Gg^Fms, Gg, Gg, Gg, Ww, Ww, Gg, Gg, Ss, Gs^Fms, Gs^Fms, Gs^Fms, Gg, Gg, Gg, Gg, Gg, Gg, Gs^Fms, Gs^Fms, Gg, Gg, Hh^Fms, Hh^Fms, Ww, Ww, Ww, Ww, Hh^Fms, Rb, Hh^Fms, Hh^Fms, Hh^Fms, Rb, Hh^Fms
Gs^Fms, Gs^Fms, Gs^Fms, Gg, Gg, Gg^Fms, Gg, Gg, Gg, Gg, Gg, Gg, Wwf, Wwf, Gg, Gg, Gs^Fms, Gs^Fms, Gs^Fms, Gs^Fms, Gg, Gs^Fms, Gs^Fms, Gs^Fms, Gs^Fms, Gs^Fms, Gg, Gg, Gg, Gg, Gg, Ww, Ww, Ww, Rb, Rb, Gs^Fms, Rb, Rb, Rb, Gs^Fms, Rb
Gs^Fms, Gs^Fms, Gs^Fms, Gs^Fms, Gs^Fms, Gg, Gg, Gg, Gg, Gg, Gg, Gg, Wwf, Wwf, Gg, Gs^Fms, Gg, Gs^Fms, Gs^Fms, Gg, Gs^Fms, Gs^Fms, Gs^Fms, Gs^Fms, Gg, Gg, Gg, Gg, Gg, Gg, Gg, Ww, Ww^Bw/, Rb, Gs^Fms, Gs^Fms, Ss, Ss, Ss, Ss, Ss, Gs^Fms
Gs^Fms, Gs^Fms, Gs^Fms, Gs^Fms, Ce, Gg, Gg, Gg, Gg, Gg, Ss, Ss, Ss, Wwf, Ss, Gs^Fms, Gg, Gg, Gg, Gg, Gg, Gg, Gg, Gg, Gg, Gg, Gg, Gg, Gg, Gg, Rb, Rb, Ww, Ww, Ss, Ss, Ss, Ss, Ss, Ss, Ss, Gs^Fms
Gs^Fms, Gs^Fms, Ce, Gg^Vct, Ce, Gg, Gg, Gg, Gg, Gg, Gg, Gg, Ww^Vm, Ww, Wwf, Ss, Gg, Gs^Fms, Gg, Gg, Gs^Fms, Gs^Fms, Ss, Ss, Ss, Gg, Gg, Gg, Gg, Rb, Gs^Fms, Gs^Fms, Gs^Fms, Ww, Ss, Ss, Ss, Ss, Ss, Ss, Gs^Fms, Gs^Fms
Rb, Ce, Ce, 2 Ket, Ce, Gg^Vct, Gg, Gg, Gg, Gg, Ss, Ss, Ss, Ww, Wwf, Gg, Gg, Ss, Gg, Gg, Gg, Ss, Gg, Ss, Gg, Gg, Gg, Gg, Gg, Rb, Gs^Fms, Gs^Fms, Gs^Fms, Ww, Ww, Ss, Gs^Fms, Gs^Fms, Gs^Fms, Gs^Fms, Gs^Fms, Gs^Fms
Gs^Fms, Rb, Ce, Gg^Vct, Ce, Gg, Gg, Gg, Gg, Gg, Gg, Gg, Gg, Ww, Wwf, Ww, Ss, Gg, Gg, Gg, Gg, Gg, Gg, Ss, Gg^Eff, Gg, Gg, Gg, Gg, Rb, Gs^Fms, Gs^Fms, Ww, Ww, Gs^Fms, Gs^Fms, Gs^Fms, Gs^Fms, Gs^Fms, Gs^Fms, Gs^Fms, Gs^Fms
Gs^Fms, Rb, Rb, Gg, Gg, Gg, Gg, Gg, Gg, Gg, Gg, Gg, Gg, Ww, Wwf, Gg, Ss, Gg, Ss, Gg, Gg, Gg, Gll^Gvs, Gll^Gvs, Gll^Gvs, Gg^Eff, Gg^Eff, Gg, Gg, Rb, Gs^Fms, Gs^Fms, Gs^Fms, Ww, Ww, Gs^Fms, Gs^Fms, Gs^Fms, Ss, Gs^Fms, Gs^Fms, Gs^Fms
Gs^Fms, Gs^Fms, Rb, Gg, Rb, Gg, Gg, Gg, Rb, Gg, Gg, Gg, Gg, Wwf, Ww, Gg, Gg, Gg, Gg, Ss, Gll^Gvs, Gll^Gvs, Gll^Gvs, Gll^Gvs, Gll^Gvs, Gg^Eff, Gg^Eff, Gg, Rb, Rb, Gs^Fms, Gs^Fms, Gs^Fms, Ww, Ww, Gs^Fms, Ww, Ss, Ss, Gs^Fms, Gs^Fms, Gs^Fms
Hh, Hh, Hh, Rb, Gg, Rb, Rb, Rb, Gg, Rb, Rb, Gg, Gs^Vh, Wwf, Wwf, Gg, Gg, Gg, Gg, Gg^Eff, Gg^Eff, Gll^Gvs, Gg^Vwm, Gll^Gvs, Gg^Eff, Gg^Eff, Gg, Gg, Rb, Gs^Fms, Gs^Fms, Gs^Fms, Gs^Fms, Gs^Fms, Gs^Fms, Ww, Ww, Ww, Ww, Ss, Ss, Gs^Fms
Hh, Hh, Hh, Gg, Gg, Gg, Gg, Gg, Gg, Gg, Gg, Rb, Rb, Ww, Ww, Wwf, Gg, Gg, Gg, Gg, Gg, Gg^Eff, Gg^Eff, Gg^Eff, Gg, Gg, Rb, Rb, Gs^Vl, Gs^Fms, Gs^Fms, Gs^Fms, Gs^Fms, Gs^Fms, Gs^Fms, Gs^Fms, Gs^Fms, Ss, Ww, Ww, Ss, Gs^Fms
Hh, Hh, Ss, Gg, Gg, Gg, Gg, Gg, Gg, Gg, Gg, Gg, Gg, Rb, Ww^Bw\, Wwf, Ch, Gg, Rb, Gg, Rb, Gg, Rb, Rb, Rb, Rb, Gg, Rb, Rb, Gs^Fms, Gs^Fms, Gs^Fms, Gs^Fms, Gs^Fms, Gs^Fms, Gs^Fms, Gs^Fms, Gs^Fms, Gs^Fms, Ss, Ss, Gs^Fms
Gs^Fms, Hh^Fms, Gg, Ss, Ss, Gg, Gg, Gg, Gg, Gg, Gg, Gg, Gg, Gg, Ww, Rb, Rb, Rb, Gs^Fms, Rb, Gs^Fms, Rb, Gs^Fms, Gs^Fms, Gs^Fms, Gg, Gg, Gg, Gg, Rb, Rb, Gs^Fms, Ce, Ce, Ce, Ce, Ce, Gs^Fms, Gs^Fms, Ss, Ss, Gs^Fms
Hh^Fms, Hh^Fms, Gg, Gg, Gg, Gg, Gg, Gg, Gg, Gg, Gg, Gg, Gg, Gg, Gg, Ww, Ww, Gg, Gg, Gs^Fms, Gg, Gg, Gg, Gg, Gg, Gs^Fms, Gg, Gg, Gg, Gg, Gg, Rb, Rb, Rb, Rb, 1 Ke, Rb, Ce, Rb, Gs^Fms, Ss, Ss
Hh^Fms, Hh^Fms, Gg, Ss, Gg, Gg, Gg, Gg, Gg, Gg, Gg, Gg, Gg, Gg, Gs^Fms, Gg, Gs^Fms, Ww, Ww, Gg, Gs^Vh, Gg, Gg, Gg, Gs^Fms, Gg, Gg, Gg, Gg, Gg, Gg, Gg, Gll^Fp, Gs^Vc, Gll^Fp, Rb, Gll^Fp, Rb, Gll^Fp, Rb, Rb, Ss
Gs^Fms, Gs^Fms, Gg, Ss, Ss, Gg, Gg, Gg, Gg, Gg, Ss, Ss, Ss, Gg, Gs^Fms, Gs^Fms, Gs^Fms, Gs^Fms, Ww, Wwf, Gs^Fms, Gs^Fms, Gs^Fms, Gg, Gg, Gg, Gg, Gg, Gg, Gg, Gg, Gll^Fp, Gll^Fp, Gll^Fp, Gll^Fp, Gll^Fp, Gll^Fp, Gll^Fp, Gll^Fp, Gll^Fp, Gll^Fp, Rb
Gs^Fms, Gs^Fms, Hh^Fms, Gs^Fms, Ss, Gg, Gg, Gg, Gg, Gg, Ss, Ss, Ss, Ss, Gs^Fms, Gs^Fms, Gs^Fms, Hh^Fms, Hh^Fms, Wwf, Ww, Gs^Fms, Ww, Gs^Fms, Gs^Fms, Gs^Fms, Ww, Ww, Ww, Gg, Ww, Gll^Fp, Gll^Fp, Gll^Fp, Ss, Gll^Fp, Ss, Ss, Ss, Gll^Fp, Ss, Ss
Gs^Fms, Gs^Fms, Ss, Hh^Fms, Hh^Fms, Gg, Hh^Fms, Gg, Gg, Gg, Gg, Ss, Ss, Ss, Chs, Gs^Fms, Hh^Fms, Hh^Fms, Gs^Fms, Wwf, Ss, Ww, Ss, Ww, Ww, Gs^Fms, Ww, Ww, Wo, Ww, Ww, Gll^Fp, Gll^Fp, Gll^Fp, Ss, Ss, Gll^Fp, Ss, Ss, Ss, Ss, Ss
Gs^Fms, Gg, Ss, Hh^Fms, Hh^Fms, Hh^Fms, Hh^Fms, Gg, Gg, Gg, Ss, Ss, Hh^Fms, Chs, Hh^Fms, Chs, Hh^Fms, Hh^Fms, Ss, Ss, Gs^Fms, Ss, Ss, Gs^Fms, Gs^Fms, Ww, Ww, Wo, Wo, Gs^Fms, Ww, Gll^Fp, Gll^Fp, Gll^Fp, Gll^Fp, Ss, Ss, Ss, Ss, Ss, Gll^Fp, Gll^Fp
Gs^Fms, Ss, Ss, Gs^Fms, Gs^Fms, Gs^Fms, Hh^Fms, Hh^Fms, Hh^Fms, Ss^Vhs, Hh^Fms, Hh^Fms, Mm, Hh^Fms, Hh, Hh^Fms, Hh^Fms, Hh^Fms, Hh^Fms, Gs^Fms, Gs^Fms, Gs^Fms, Gs^Fms, Gs^Fms, Gs^Fms, Ww, Wo, Wo, Wo, Ww, Ss, Ww, Gll^Fp, Gll^Fp, Gll^Fp, Gll^Fp, Gll^Fp, Ss, Gll^Fp, Ss, Gll^Fp, Gll^Fp
Gs^Fms, Gs^Fms, Gs^Fms, Gs^Fms, Gs^Fms, Gs^Fms, Hh^Fms, Hh^Fms, Hh^Fms, Hh^Fms, Hh^Fms, Hh^Fms, Hh^Fms, Mm, Mm, Hh, Hh, Hh^Fms, Ss, Gs^Fms, Gs^Fms, Gs^Fms, Gs^Fms, Gs^Fms, Gs^Fms, Ww, Ww, Wo, Wo, Ww, Ss, Ss, Ss, Ss, Gll^Fp, Gll^Fp, Gs^Efm, Gs^Efm, Gs^Efm, Gll^Fp, Gll^Fp, Gll^Fp
Gs^Fms, Gs^Fms, Gs^Fms, Gs^Fms, Gs^Fms, Hh^Fms, Hh^Fms, Hh^Fms, Gs^Fms, Hh^Fms, Ss, Ss, Ss, Hh^Fms, Mm, Hh, Hh, Ss, Mm^Fms, Mm, Mm, Gs^Fms, Mm, Hh^Fms, Hh^Fms, Gg, Ww, Wo, Wo, Ww, Ss, Ss, Ss, Ss, Ss, Gs^Efm, Gg^Efm, Gd^Efm, Gg^Efm, Gs^Efm, Gll^Fp, Gll^Fp
Gs^Fms, Gs^Fms, Gs^Fms, Gs^Fms, Gs^Fms, Hh^Fms, Gs^Fms, Gs^Fms, Gs^Fms, Gs^Fms, Gs^Fms, Ss, Ss, Hh^Fms, Mm, Mm, Mm, Mm, Mm, Mm, Mm, Mm, Mm, Hh^Fms, Hh^Fms, Hh^Fms, Ww, Ww, Ww, Ss, Ss, Ss, Ss, Ss, Gg^Efm, Gg^Efm, Gd^Efm, Gd^Efm, Gd^Efm, Gg^Efm, Gg^Efm, Gll^Fp
Gs^Fms, Gs^Fms, Gs^Fms, Gs^Fms, Gs^Fms, Gs^Fms, Gs^Fms, Gs^Fms, Gs^Fms, Gs^Fms, Gs^Fms, Gs^Fms, Hh^Fms, Mm, Mm, Mm, Mm, Mm, Mm, Mm, Mm, Mm, Mm, Mm, Hh^Fms, Hh^Fms, Gg^Fms, Ww, Ww, Ww, Ww, Ss, Gll^Fp, Gll^Fp, Gll^Fp, Gg^Efm, Gll^Fp, Gg^Efm, Gg^Efm, Gg^Efm, Gg^Efm, Gll^Fp
Gs^Fms, Gs^Fms, Gs^Fms, Gs^Fms, Gs^Fms, Gs^Fms, Gs^Fms, Gs^Fms, Gs^Fms, Gs^Fms, Gs^Fms, Gs^Fms, Hh^Fms, Mm, Mm, Mm, Mm, Mm, Mm, Mm, Mm, Mm, Mm, Mm, Hh^Fms, Hh^Fms, Hh^Fms, Ww, Ww, Ww, Ww, Ww, Gg, Gll^Fp, Gll^Fp, Gll^Fp, Gll^Fp, Gll^Fp, Gll^Fp, Gll^Fp, Gll^Fp, Gll^Fp
